13 B 11 N
WWWWWWWWWWWWW
WW__P_______W
W___WG______W
W___________W
WP_P_P______W
W___________W
WP___P______W
W______U____W
W___________W
W___________W
W________U__W
W__P_______WW
WWWWWWWWWWWWW