13 C 8 N
WWWWWWWWWWWWW
WW__P_______W
W___WP______W
W___________W
WP___P___U__W
W_______WW__W
WP___P______W
W_______GW__W
W_____U_____W
W________W__W
W_____W_____W
W__P_______WW
WWWWWWWWWWWWW