5 D 4 N
WWWWW
WW_PW
W_UWW
W_G_W
WWWWW