13 C 8 N
WWWWWWWWWWWWW
WW__P_______W
W___WP______W
W_U_________W
WP___P______W
W_______WW__W
WP____P_____W
W_____U_GW__W
W___________W
W________W__W
W_____W_____W
W__P_______WW
WWWWWWWWWWWWW