8 D 4 N
WWWWWWWW
WW__P__W
W___WG_W
W______W
WP_P_P_W
W___U__W
WP_U_P_W
WWWWWWWW